1111111111111111111
101000E010101000001
1010111110101110101
1P0C100010100000101
1C11111010111011111
1000101000101000001
1C11101110101111101
1000101000001000101
1110101110101011101
1000000000100000101
1C11111111101111101
1000000000100000001
1111111111111111111