11111111111111111111111111111111111111111
1P001E00100000000000000010001010101000101
11111C11111010101111111110111010101010101
10100C00001010101000100010000010000010001
10101111101011101011101111101111111011101
10101010001000100000001010001000000010001
10111010101110111010111010111111101111101
10000000100000001010000010001000001000101
10111010111011101111111011101110111011111
10001010100000101000000010101000000000001
11101111101011111011101110101011101011111
10000010001000101010000010001010001000101
11111011101111101011111111101111111010101
10000000100010001010000000100010100010101
10101011111010101011111010101110101010101
10101010000010101000000010000010001010001
11111011111011101111101111111111111110111
10100000101000001010000000000000001010001
10111111101011111010111011111110101010111
10001000001000000010100000101000100000001
10111011101011111110111011101111101111101
10100010000010001010001010100010100010101
10111111111111101011101110111010101110101
10101000000010001010001000000000100000101
10101111111010101010101010101111101110111
10000000100000100010100010101000001000101
10101011111111101110101110101111111011101
10101000000010100010101010100010001000101
11111110111110111011101011111011101011101
10101000000000101000000000101010100000001
10101010101111101110111111101110101011111
10000010100000100000001000000000101000001
10111111111011111010111111101111111010111
10001000001010001010100000100000001010101
11111110111010101010101111111010111010101
10000010001000100010100000100010001010001
10111010101110111111101111101111111111101
10101010101000100010100010100010001000101
10101011101011101110101010101111101110101
10001000000000001000001000000000000000001
11111111111111111111111111111111111111111
