11111
1P1C1
1E101
10001
11111

00000
01010
01010
01110
00000

