0000000000000000000000000
0111111101111111011111110
0100000101000001010000010
0100000101000001010000010
0100000101000001010000010
0111011111110111111101110
0001010000010100000101000
0001010000010100000101000
0001011101110111011101000
000100000000P0000E0001000
000100000000000C000001000
0001111111111111111111000
0000000000000000000000000