11111111111
10000000001
10100100101
10000001101
10000P01101
10000001101
10000000001
10000000001
11111111111